5 2 2
1 1 1 1 1
1 0 0 0 1
1 0 0 0 1
1 0 0 67 1
1 1 1 1 1
